1111111111
1001000001
1001000001
1001000001
1010000001
1001000001
1000000101
1000000101
1000000101
1111111111
